13
 1  1  9  9  9  8  8  8  9  7 10  1  1 13
 9  9  8  5  7  6  8  9  8  9  5 11 12 13
 1  2  2  1  4  3  4  5  6  6 10  2  2 12
 5  8  4  4  5  9  6  8  7  8  4 11 12 13
 2  1  1  2  3  3  4  7  6  5 10  3  3 11
 6  3  7  3  8  4  5  6  7  7  3 11 12 13
 2  1  1  2  3  3  4  6  5  7 10  4  4 10
 2  2  7  6  4  7  3  9  5  6  2 11 12 13
 1  2  2  1  4  3  3  4  5  5 10  5  5  9
10 10 10  9 10  8 10  7 10  6  1 11 12 13
11 11 11 10 11  9 11  8 11  7 11  6  6  8
12 12 12 11 12 10 12  9 12  8 12  7 12 13
13  1 13  2 13  3 13  4 13  5 13  6 13  7