1 1 2 2 3 3 4 4 5 5 6 6 7 8 
9 10 11 12 13 14 15 16 17 18 19 19 7 8 
9 10 11 12 13 14 15 16 17 18 20 20 21 21 
22 23 24 25 26 27 28 29 29 30 31 31 32 32 
22 23 24 25 26 27 28 33 33 30 34 34 35 36 
37 38 39 40 40 41 41 42 43 43 44 44 35 36 
37 38 39 45 45 46 46 42 47 47 48 48 49 50 
51 51 52 53 54 55 55 56 57 57 58 58 49 50 
59 59 52 53 54 60 60 56 61 61 62 62 63 64 
65 65 66 66 67 67 68 68 69 69 70 70 63 64 
71 71 72 72 73 73 74 74 75 75 76 76 77 78 
79 79 80 80 81 81 82 82 83 83 84 84 77 78 
85 85 86 86 87 87 88 88 89 89 90 90 91 91 
