2 2
8 6 
-1 -1 -1 -1  -1 -1 -1 -1
-1  0  0  0   7  0  0  0
-1  0 -1 -1  -1 -1 -1 -1
-1  0 -1 -1 107 -1 -1 -1
-1  0  0  0   0 -1 -1 -1
-1 -1 -1 -1  -1 -1 -1 -1

