15 15 5
SOOOOOOOOOFFFFF
OOOOOOOOOOFFFFF
OOOOOOOOOOFFFFF
OOOOOOOOOOOOOOO
OOOOOOOOOOOOOOO
OOOOOOOOOOOOOOO
OOOOOOOOOOOOOOO
OFOOOOOOOOOOOOO
OOOOOOOOOOOOOOO
OOOOOOOOOOOOOOO
OOOOOOOOOOOOOOO
OOOOOOOOOOOOOOO
OOOOOOOOFOOOOOO
OOOOOOOOOOOOOOO
OOOOOOOOOOOOOOY
