0000000000
0000000000
00###00000
0000###000
000000#000
000000$000
0000$$$000
0000000000
0000000000