5
. . . . .
S * . * *
. * . . .
. * . * .
. . . * T