24 7 5 -5 16 25 -12 27 23 17
5 21 -4 10 23 13 10 22 7 18
-21 5 -9 -20 -21 18 15 14 19 26
9 12 20 22 25 -13 27 28 29 10
3 18 -21 5 -4 23 -14 20 19 27
-20 29 -11 26 -2 28 -15 23 9 10
7 23 -5 -24 16 20 -10 24 24 19
15 21 -14 10 23 19 12 29 -22 21
-21 15 -24 -20 20 -11 26 -21 23 28
5 19 -4 18 23 19 12 29 -22 21